╔═══════╗
║·····•·║
║···c ··║
║·······║
╚═══════╝