╔════════════╗╔════════════╗
║············║║············║
║·╔══╗·╔═══╗·║║·╔═══╗·╔══╗·║
║•║  ║·║   ║·║║·║   ║·║  ║•║
║·╚══╝·╚═══╝·╚╝·╚═══╝·╚══╝·║
║··························║
║·╔══╗·╔╗·╔══════╗·╔╗·╔══╗·║
║·╚══╝·║║·╚══╗╔══╝·║║·╚══╝·║
║······║║····║║····║║······║
╚════╗·║╚══╗·║║·╔══╝║·╔════╝
     ║·║╔══╝·╚╝·╚══╗║·║     
     ║·║║····b ····║║·║     
     ║·║║·╔══--══╗·║║·║     
═════╝·╚╝·║      ║·╚╝·╚═════
··········║      ║··········
═════╗·╔╗·║      ║·╔╗·╔═════
     ║·║║·╚══════╝·║║·║     
     ║·║║····c ····║║·║     
     ║·║║·╔══════╗·║║·║     
╔════╝·╚╝·╚══╗╔══╝·╚╝·╚════╗
║············║║············║
║·╔══╗·╔═══╗·║║·╔═══╗·╔══╗·║
║·╚═╗║·╚═══╝·╚╝·╚═══╝·║╔═╝·║
║•··║║················║║··•║
╚═╗·║║·╔╗·╔══════╗·╔╗·║║·╔═╝
╔═╝·╚╝·║║·╚══╗╔══╝·║║·╚╝·╚═╗
║······║║····║║····║║······║
║·╔════╝╚══╗·║║·╔══╝╚════╗·║
║·╚════════╝·╚╝·╚════════╝·║
║··························║
╚══════════════════════════╝