╔══════════════════════════╗
║··························║
║··························║
║··························║
║··························║
║··························║
║··························║
║··························║
║··························║
║··························║
║···········b··············║
║··························║
║··························║
║··························║
║··························║
║··························║
║··························║
║···············c··········║
║··························║
║··························║
╚══════════════════════════╝