############################
#............##............#
#.####.#####.##.#####.####.#
#.####.#####.##.#####.####.#
#.####.#####.##.#####.####.#
#..........................#
#.####.##.######## ##.####.#
#.####.##.######## ##.####.#
#......##....##....##......#
######.##### ## #####.######
######.##### ## #####.######
######.##..........##.######
######.##.###--###.##.######
######.##.#      #.##.######
..........#      #..........
######.##.#      #.##.######
######.##.########.##.######
######.##....c.....##.######
######.#####.##.#####.######
######.#####.##.#####.######
#......##....##....##......#
#.####.##.########.##.####.#
#.####.##.########.##.####.#
#.####.#####.##.#####.####.#
#.####.#####.##.#####.####.#
#.####.#####.##.#####.####.#
#............##............#
############################