╔════════════╗╔════════════╗
║............║║............║
║.╔══╗.╔═══╗.║║.╔═══╗.╔══╗.║
║.║--║.║---║.║║.║---║.║--║.║
║.╚══╝.╚═══╝.╚╝.╚═══╝.╚══╝.║
║..........................║
║.╔══╗.╔╗.╔══════╗.╔╗.╔══╗.║
║.╚══╝.║║.╚══╗╔══╝.║║.╚══╝.║
║......║║....║║....║║......║
╚════╗.║╚══╗ ║║ ╔══╝║.╔════╝
-----║.║╔══╝ ╚╝ ╚══╗║.║-----
-----║.║║..........║║.║-----
-----║.║║.╔══--══╗.║║.║-----
═════╝.╚╝.║      ║.╚╝.╚═════
..........║      ║..........
═════╗.╔╗.║      ║.╔╗.╔═════
-----║.║║.╚══════╝.║║.║-----
-----║.║║....c.....║║.║-----
-----║.║║.╔══════╗.║║.║-----
╔════╝.╚╝.╚══╗╔══╝.╚╝.╚════╗
║............║║............║
║.╔══╗.╔═══╗.║║.╔═══╗.╔══╗.║
║.╚═╗║.╚═══╝.╚╝.╚═══╝.║╔═╝.║
║...║║................║║...║
╚═╗.║║.╔╗.╔══════╗.╔╗.║║.╔═╝
╔═╝.╚╝.║║.╚══╗╔══╝.║║.╚╝.╚═╗
║......║║....║║....║║......║
║.╔════╝╚══╗.║║.╔══╝╚════╗.║
║.╚════════╝.╚╝.╚════════╝.║
║..........................║
╚══════════════════════════╝