############################
#            ##            #
# #### ##### ## ##### #### #
# #### ##### ## ##### #### #
# #### ##### ## ##### #### #
#                          #
# #### ## ######## ## #### #
# #### ## ######## ## #### #
#      ##    ##    ##      #
###### ##### ## ##### ######
###### ##### ## ##### ######
###### ##          ## ######
###### ## ###--### ## ######
###### ## #      # ## ######
          #      #
###### ## #      # ## ######
###### ## ######## ## ######
###### ##          ## ######
###### ##### ## ##### ######
###### ##### ## ##### ######
#      ##    ##    ##      #
# #### ## ######## ## #### #
# #### ## ######## ## #### #
# #### ##### ## ##### #### #
# #### ##### ## ##### #### #
# #### ##### ## ##### #### #
#            ##            #
############################