############################
#............##............#
#.####.#####.##.#####.####.#
#.#--#.#---#.##.#---#.#--#.#
#.####.#####.##.#####.####.#
#..........................#
#.####.##.######## ##.####.#
#.####.##.######## ##.####.#
#......##....##....##......#
######.##### ## #####.######
-----#.##### ## #####.#-----
-----#.##..........##.#-----
-----#.##.###--###.##.#-----
######.##.#      #.##.######
..........#      #..........
######.##.#      #.##.######
-----#.##.########.##.#-----
-----#.##....c.....##.#-----
-----#.##.########.##.#-----
######.##.########.##.######
#............##............#
#.####.#####.##.#####.####.#
#.####.#####.##.#####.####.#
#...##................##...#
###.##.##.########.##.##.###
###.##.##.########.##.##.###
#......##....##....##......#
#.##########.##.##########.#
#.##########.##.##########.#
#..........................#
############################