╔════════════╗╔════════════╗
║············║║············║
║·╔══╗·╔═══╗·║║·╔═══╗·╔══╗·║
║·║--║·║---║·║║·║---║·║--║·║
║·╚══╝·╚═══╝·╚╝·╚═══╝·╚══╝·║
║··························║
║·╔══╗·╔╗·╔══════╗·╔╗·╔══╗·║
║·╚══╝·║║·╚══╗╔══╝·║║·╚══╝·║
║······║║····║║····║║······║
╚════╗·║╚══╗ ║║ ╔══╝║·╔════╝
-----║·║╔══╝ ╚╝ ╚══╗║·║-----
-----║·║║··········║║·║-----
-----║·║║·╔══--══╗·║║·║-----
═════╝·╚╝·║      ║·╚╝·╚═════
··········║b     ║··········
═════╗·╔╗·║      ║·╔╗·╔═════
-----║·║║·╚══════╝·║║·║-----
-----║·║║····c ····║║·║-----
-----║·║║·╔══════╗·║║·║-----
╔════╝·╚╝·╚══╗╔══╝·╚╝·╚════╗
║············║║············║
║·╔══╗·╔═══╗·║║·╔═══╗·╔══╗·║
║·╚═╗║·╚═══╝·╚╝·╚═══╝·║╔═╝·║
║···║║················║║···║
╚═╗·║║·╔╗·╔══════╗·╔╗·║║·╔═╝
╔═╝·╚╝·║║·╚══╗╔══╝·║║·╚╝·╚═╗
║······║║····║║····║║······║
║·╔════╝╚══╗·║║·╔══╝╚════╗·║
║·╚════════╝·╚╝·╚════════╝·║
║··························║
╚══════════════════════════╝