╔════════════╗╔════════════╗
║············║║············║
║·╔══╗·╔═══╗·║║·╔═══╗·╔══╗·║
║•║--║·║---║·║║·║---║·║--║•║
║·╚══╝·╚═══╝·╚╝·╚═══╝·╚══╝·║
║··························║
║·╔══╗·╔╗·╔══════╗·╔╗·╔══╗·║
║·╚══╝·║║·╚══╗╔══╝·║║·╚══╝·║
║······║║····║║····║║······║
╚════╗·║╚══╗·║║·╔══╝║·╔════╝
-----║·║╔══╝·╚╝·╚══╗║·║-----
-----║·║║··········║║·║-----
-----║·║║·╔══--══╗·║║·║-----
═════╝·╚╝·║      ║·╚╝·╚═════
··········║b     ║··········
═════╗·╔╗·║      ║·╔╗·╔═════
-----║·║║·╚══════╝·║║·║-----
-----║·║║····c ····║║·║-----
-----║·║║·╔══════╗·║║·║-----
╔════╝·╚╝·╚══╗╔══╝·╚╝·╚════╗
║············║║············║
║·╔══╗·╔═══╗·║║·╔═══╗·╔══╗·║
║·╚═╗║·╚═══╝·╚╝·╚═══╝·║╔═╝·║
║•··║║················║║··•║
╚═╗·║║·╔╗·╔══════╗·╔╗·║║·╔═╝
╔═╝·╚╝·║║·╚══╗╔══╝·║║·╚╝·╚═╗
║······║║····║║····║║······║
║·╔════╝╚══╗·║║·╔══╝╚════╗·║
║·╚════════╝·╚╝·╚════════╝·║
║··························║
╚══════════════════════════╝